00000000000
01010111110
11010001010
01110111010
01000001010
01110111010
01000100000
01110111110
01000100010
01111111011
00000000000
